State_FIPS,County_FIPS,County,R_Perdue_Election_Day,R_Perdue_Absentee_Mail,R_Perdue_Advanced_Voting,R_Perdue_Provisional,R_Perdue_Total,D_Ossoff_Election_Day,D_Ossoff_Absentee_Mail,D_Ossoff_Advanced_Voting,D_Ossoff_Provisional,D_Ossoff_Total,L_Hazel_Election_Day,L_Hazel_Absentee_Mail,L_Hazel_Advanced_Voting,L_Hazel_Provisional,L_Hazel_Total,Total
13,001,Appling,1686,837,3774,9,6306,352,553,845,3,1753,33,21,74,0,128,8187
13,003,Atkinson,709,170,1392,1,2272,220,123,430,0,773,23,3,26,0,52,3097
13,005,Bacon,417,465,3047,0,3929,127,187,276,1,591,24,9,37,0,70,4590
13,007,Baker,289,131,451,2,873,145,230,273,0,648,4,2,7,0,13,1534
13,009,Baldwin,1845,1291,5733,4,8873,1500,2837,4445,1,8783,110,93,223,0,426,18082
13,011,Banks,1595,982,5048,11,7636,152,325,420,2,899,56,27,106,1,190,8725
13,013,Barrow,5685,4024,16606,2,26317,1762,3334,4966,4,10066,361,243,589,0,1193,37576
13,015,Bartow,9917,5865,21209,17,37008,2188,4149,5318,8,11663,482,291,587,1,1361,50032
13,017,Ben Hill,427,507,3143,0,4077,338,664,1281,1,2284,25,28,63,0,116,6477
13,019,Berrien,1789,728,3760,0,6277,324,331,548,0,1203,56,28,75,0,159,7639
13,021,Bibb,7870,5425,13275,0,26570,8604,13247,19864,0,41715,440,360,604,0,1404,69689
13,023,Bleckley,931,603,2745,2,4281,292,383,574,0,1249,33,21,60,0,114,5644
13,025,Brantley,1924,663,4218,7,6812,163,190,334,1,688,46,12,58,0,116,7616
13,027,Brooks,1401,531,2312,6,4250,505,1010,1088,4,2607,36,26,57,0,119,6976
13,029,Bryan,2518,1562,9983,4,14067,853,1962,3679,3,6497,146,108,345,0,599,21163
13,031,Bulloch,6562,2751,8898,21,18232,2402,3295,5115,34,10846,272,139,304,0,715,29793
13,033,Burke,1934,663,2810,0,5407,1448,1751,1790,0,4989,63,43,58,0,164,10560
13,035,Butts,823,1123,6380,0,8326,372,892,1863,0,3127,29,46,140,0,215,11668
13,037,Calhoun,281,149,503,0,933,348,419,444,0,1211,15,3,10,0,28,2172
13,039,Camden,3495,2133,9355,4,14987,1143,2482,3839,3,7467,284,179,432,0,895,23349
13,043,Candler,1570,356,1147,0,3073,517,350,357,1,1225,33,10,17,0,60,4358
13,045,Carroll,10850,4597,21525,25,36997,2960,4251,8328,10,15549,496,273,653,5,1427,53973
13,047,Catoosa,5017,2835,16704,15,24571,964,1934,3695,6,6599,303,139,561,1,1004,32174
13,049,Charlton,1097,394,1865,1,3357,222,253,540,0,1015,31,15,58,0,104,4476
13,051,Chatham,18198,11846,22903,0,52947,17738,27457,30625,0,75820,1241,788,938,0,2967,131734
13,053,Chattahoochee,279,124,445,2,850,149,152,333,2,636,20,15,25,0,60,1546
13,055,Chattooga,2378,1045,4350,4,7777,391,628,865,2,1886,86,60,129,0,275,9938
13,057,Cherokee,23455,19695,56129,0,99279,6345,15488,17989,0,39822,1438,1027,1737,0,4202,143303
13,059,Clarke,3469,4307,7253,13,15042,5123,13409,15905,34,34471,431,380,506,4,1321,50834
13,061,Clay,128,113,406,0,647,166,266,316,0,748,5,10,6,0,21,1416
13,063,Clayton,3007,4031,7687,0,14725,16666,25198,50780,0,92644,658,680,1129,0,2467,109836
13,065,Clinch,605,213,1264,1,2083,212,130,318,0,660,16,8,30,0,54,2797
13,067,Cobb,37580,53543,78099,150,169372,29518,88393,92520,310,210741,3112,3470,3649,22,10253,390366
13,069,Coffee,2522,877,6981,0,10380,1062,877,2298,0,4237,85,44,155,0,284,14901
13,071,Colquitt,4205,1331,6098,9,11643,1083,1104,1799,3,3989,109,46,101,0,256,15888
13,073,Columbia,13296,7069,29810,45,50220,4837,8779,14116,27,27759,678,366,880,4,1928,79907
13,075,Cook,1104,472,3288,0,4864,521,481,960,1,1963,41,25,79,0,145,6972
13,077,Coweta,18105,9404,23787,3,51299,5199,8503,9201,12,22915,786,496,621,5,1908,76122
13,079,Crawford,1126,532,2671,1,4330,262,492,806,1,1561,39,32,64,0,135,6026
13,081,Crisp,978,795,3277,4,5054,545,829,1434,1,2809,33,19,53,0,105,7968
13,083,Dade,1942,614,3310,5,5871,268,346,637,2,1253,70,28,110,0,208,7332
13,085,Dawson,2279,1926,9009,0,13214,250,941,1096,0,2287,113,77,227,0,417,15918
13,087,Decatur,1448,816,4426,6,6696,777,1366,2414,6,4563,43,48,99,0,190,11449
13,089,DeKalb,12225,17712,31688,37,61662,33147,104427,159486,250,297310,1728,2230,3283,9,7250,366222
13,091,Dodge,2306,701,2781,0,5788,530,520,970,0,2020,48,21,69,0,138,7946
13,093,Dooly,467,266,1422,3,2158,460,441,923,2,1826,24,13,38,0,75,4059
13,095,Dougherty,4271,2399,3882,23,10575,7206,7590,8914,79,23789,222,121,156,1,500,34864
13,097,Douglas,4547,5324,14997,0,24868,5785,13290,22525,0,41600,446,453,731,0,1630,68098
13,099,Early,817,426,1550,0,2793,595,635,1002,0,2232,29,11,37,0,77,5102
13,101,Echols,221,114,897,0,1232,31,30,101,0,162,5,5,14,0,24,1418
13,103,Effingham,7167,2375,13273,16,22831,1781,2247,3590,9,7627,352,153,322,1,828,31286
13,105,Elbert,1836,990,3399,0,6225,500,1006,1211,0,2717,44,21,68,0,133,9075
13,107,Emanuel,2510,892,3110,1,6513,814,727,1179,0,2720,51,27,57,1,136,9369
13,109,Evans,463,491,1922,0,2876,227,305,719,0,1251,16,15,33,0,64,4191
13,111,Fannin,4070,2202,5678,0,11950,383,1055,977,0,2415,113,79,105,0,297,14662
13,113,Fayette,6331,7602,22862,0,36795,3344,10282,16672,0,30298,386,362,761,0,1509,68602
13,115,Floyd,7718,4340,14508,105,26671,2159,3669,4621,21,10470,350,244,414,0,1008,38149
13,117,Forsyth,9587,14980,61047,0,85614,3244,14103,21855,0,39202,668,727,1988,0,3383,128199
13,119,Franklin,2269,1379,5345,0,8993,323,537,603,2,1465,65,40,82,0,187,10645
13,121,Fulton,19520,33275,92262,881,145938,36258,106841,215786,2368,361253,2300,2712,5821,140,10973,518164
13,123,Gilmer,4271,2102,6787,0,13160,435,1106,1151,0,2692,140,93,151,0,384,16236
13,125,Glascock,396,195,775,0,1366,42,49,59,0,150,7,1,16,0,24,1540
13,127,Glynn,4620,4413,16497,30,25560,2084,5244,7589,21,14938,266,215,488,1,970,41468
13,129,Gordon,6814,2471,9713,13,19011,1011,1323,1848,0,4182,219,102,250,2,573,23766
13,131,Grady,2002,1073,3887,0,6962,620,1038,1797,0,3455,51,29,66,0,146,10563
13,133,Greene,864,1323,5057,3,7247,544,1380,1832,7,3763,43,38,71,0,152,11162
13,135,Gwinnett,34576,41296,90661,0,166533,35117,76886,121145,0,233148,3126,3070,4671,0,10867,410548
13,137,Habersham,2551,2851,10964,0,16366,493,1197,1647,0,3337,140,107,286,0,533,20236
13,139,Hall,10855,12019,40901,0,63775,3778,8321,11362,0,23461,682,567,1210,0,2459,89695
13,141,Hancock,287,247,639,0,1173,601,1158,1096,3,2858,14,20,32,0,66,4097
13,143,Haralson,4195,1710,6107,4,12016,407,617,740,0,1764,123,71,142,0,336,14116
13,145,Harris,5527,2117,6622,13,14279,1264,1899,2025,4,5192,170,103,109,1,383,19854
13,147,Hart,2306,1399,5671,1,9377,543,1016,1376,2,2937,73,37,108,0,218,12532
13,149,Heard,1611,656,2145,1,4413,192,271,338,1,802,31,25,57,0,113,5328
13,151,Henry,7902,7976,31581,27,47486,8215,19706,43606,65,71592,572,655,1401,3,2631,121709
13,153,Houston,11487,8252,21645,44,41428,6274,11016,13621,44,30955,632,521,623,3,1779,74162
13,155,Irwin,634,373,2085,3,3095,241,236,504,1,982,15,5,47,0,67,4144
13,157,Jackson,4867,4324,19969,6,29166,1026,2550,3685,1,7262,256,209,490,0,955,37383
13,159,Jasper,1503,798,3438,12,5751,296,634,759,1,1690,56,36,59,0,151,7592
13,161,Jeff Davis,1377,516,2681,0,4574,249,262,502,0,1013,40,17,54,0,111,5698
13,163,Jefferson,1103,444,1988,4,3539,1028,1199,1679,7,3913,32,24,46,0,102,7554
13,165,Jenkins,576,331,1245,3,2155,280,383,530,1,1194,22,14,15,0,51,3400
13,167,Johnson,754,336,1711,0,2801,210,374,574,0,1158,16,19,40,0,75,4034
13,169,Jones,2954,1287,5609,4,9854,835,1568,2282,2,4687,109,59,133,0,301,14842
13,171,Lamar,1713,797,3762,0,6272,471,877,1160,0,2508,74,43,80,0,197,8977
13,173,Lanier,469,248,1764,0,2481,187,269,488,0,944,32,16,46,0,94,3519
13,175,Laurens,5596,2281,6472,0,14349,1809,2571,3294,0,7674,150,101,162,0,413,22436
13,177,Lee,2989,1188,7681,4,11862,889,1157,2376,2,4424,102,47,124,0,273,16559
13,179,Liberty,1624,1238,4866,0,7728,1668,4022,7005,0,12695,162,172,274,0,608,21031
13,181,Lincoln,901,418,1816,0,3135,253,596,521,0,1370,22,25,36,0,83,4588
13,183,Long,1068,258,2054,9,3389,392,484,1147,6,2029,62,24,76,1,163,5581
13,185,Lowndes,5299,3357,16803,161,25620,2786,5479,10617,242,19124,282,190,532,24,1028,45772
13,187,Lumpkin,1973,1971,7993,0,11937,303,1129,1492,0,2924,122,99,275,0,496,15357
13,193,Macon,348,138,1301,0,1787,669,663,1395,0,2727,22,18,39,0,79,4593
13,195,Madison,3253,1659,6039,2,10953,683,1126,1455,1,3265,132,92,127,0,351,14569
13,197,Marion,724,302,1222,0,2248,232,440,595,0,1267,32,14,38,0,84,3599
13,189,McDuffie,841,910,4447,0,6198,574,1439,1955,0,3968,47,38,119,0,204,10370
13,191,McIntosh,800,802,2364,1,3967,424,808,1266,0,2498,51,32,54,0,137,6602
13,199,Meriwether,2164,985,3281,2,6432,1177,1378,1575,5,4135,78,47,70,0,195,10762
13,201,Miller,525,262,1258,2,2047,166,200,321,0,687,14,12,21,0,47,2781
13,205,Mitchell,1539,690,2690,2,4921,794,1411,1622,5,3832,43,25,50,0,118,8871
13,207,Monroe,3005,1060,6858,6,10929,701,1258,2244,2,4205,112,55,127,0,294,15428
13,209,Montgomery,1085,353,1488,0,2926,251,279,398,0,928,30,9,23,0,62,3916
13,211,Morgan,1874,930,5450,3,8257,467,962,1721,1,3151,59,62,96,0,217,11625
13,213,Murray,3756,1275,7462,0,12493,569,637,1090,0,2296,105,63,194,0,362,15151
13,215,Muscogee,6417,6599,17160,18,30194,6498,16348,24577,28,47451,460,481,822,3,1766,79411
13,217,Newton,10672,4713,8008,14,23407,6759,10013,12419,16,29207,481,340,325,4,1150,53764
13,219,Oconee,2718,2873,11514,2,17107,658,2695,4108,2,7463,158,107,303,1,569,25139
13,221,Oglethorpe,1046,918,3534,0,5498,405,813,1103,0,2321,46,62,125,0,233,8052
13,223,Paulding,9418,9296,34709,0,53423,3744,9831,15138,0,28713,604,571,1128,0,2303,84439
13,225,Peach,957,808,4709,9,6483,799,1638,3259,6,5702,50,44,152,1,247,12432
13,227,Pickens,5867,1776,6209,8,13860,655,1020,1003,0,2678,223,70,138,0,431,16969
13,229,Pierce,1184,926,5700,0,7810,124,303,575,0,1002,28,22,78,0,128,8940
13,231,Pike,2318,890,5834,0,9042,272,479,677,0,1428,60,35,79,0,174,10644
13,233,Polk,2762,1645,8862,13,13282,614,1004,1914,5,3537,112,89,214,1,416,17235
13,235,Pulaski,332,314,2141,0,2787,153,309,677,0,1139,17,14,48,0,79,4005
13,237,Putnam,1536,1764,4978,1,8279,461,1374,1464,0,3299,56,60,73,0,189,11767
13,239,Quitman,158,93,349,0,600,156,125,188,1,470,8,3,4,0,15,1085
13,241,Rabun,1167,1652,4573,0,7392,188,794,843,0,1825,66,78,111,0,255,9472
13,243,Randolph,321,217,866,0,1404,395,437,771,3,1606,9,6,16,0,31,3041
13,245,Richmond,8524,6321,12128,0,26973,11595,19799,25080,0,56474,699,645,769,0,2113,85560
13,247,Rockdale,2418,2949,7335,14,12716,3574,8964,18083,20,30641,217,227,462,0,906,44263
13,249,Schley,303,154,1325,1,1783,63,142,234,0,439,7,9,18,0,34,2256
13,251,Screven,1243,524,2117,8,3892,601,729,1251,8,2589,29,7,29,0,65,6546
13,253,Seminole,934,267,1392,0,2593,291,236,657,0,1184,21,7,26,0,54,3831
13,255,Spalding,5118,3413,8720,517,17768,2550,3957,4498,350,11355,237,193,190,21,641,29764
13,257,Stephens,1204,1379,6766,4,9353,289,687,1211,0,2187,54,56,118,0,228,11768
13,259,Stewart,225,116,457,5,803,282,349,477,7,1115,13,4,18,0,35,1953
13,261,Sumter,1510,840,3381,12,5743,1122,1930,3056,6,6114,49,30,86,0,165,12022
13,263,Talbot,465,239,680,0,1384,528,873,611,0,2012,18,15,18,0,51,3447
13,265,Taliaferro,99,66,201,0,366,97,210,214,0,521,2,8,5,0,15,902
13,267,Tattnall,1492,799,3658,0,5949,412,508,1058,0,1978,57,27,73,0,157,8084
13,269,Taylor,346,298,1743,12,2399,273,451,586,2,1312,12,16,53,0,81,3792
13,271,Telfair,932,356,1461,0,2749,309,578,541,0,1428,25,11,32,0,68,4245
13,273,Terrell,675,273,1092,0,2040,548,805,923,1,2277,18,14,26,0,58,4375
13,275,Thomas,2708,1665,8646,1,13020,1387,2199,4568,4,8158,138,82,202,0,422,21600
13,277,Tift,2703,1247,6853,11,10814,1048,1304,2590,14,4956,104,54,145,2,305,16075
13,279,Toombs,1778,1191,4820,4,7793,574,1001,1251,6,2832,43,45,85,0,173,10798
13,281,Towns,955,1199,4129,8,6291,123,655,672,1,1451,34,49,63,0,146,7888
13,283,Treutlen,405,280,1393,0,2078,119,269,505,0,893,18,8,26,0,52,3023
13,285,Troup,4656,2906,10556,47,18165,2736,3238,5118,26,11118,205,114,214,3,536,29819
13,287,Turner,366,234,1733,1,2334,322,269,753,1,1345,20,8,34,0,62,3741
13,289,Twiggs,807,314,1190,0,2311,431,686,862,0,1979,35,19,33,0,87,4377
13,291,Union,3327,2184,6901,11,12423,292,1169,1155,0,2616,102,91,146,0,339,15378
13,293,Upson,1355,1170,6038,0,8563,616,1474,1910,0,4000,54,55,107,0,216,12779
13,295,Walker,5423,3415,13805,7,22650,952,1997,2483,3,5435,303,155,425,0,883,28968
13,297,Walton,8813,5925,22431,0,37169,2063,3932,6107,0,12102,391,275,520,0,1186,50457
13,299,Ware,2538,1431,5864,0,9833,536,1484,1953,0,3973,81,51,137,0,269,14075
13,301,Warren,190,215,767,0,1172,291,517,616,0,1424,11,12,23,0,46,2642
13,303,Washington,1455,730,2441,4,4630,1020,1661,1790,6,4477,63,45,64,0,172,9279
13,305,Wayne,2426,1280,6022,6,9734,466,705,1482,2,2655,69,55,120,0,244,12633
13,307,Webster,136,122,478,0,736,141,215,270,0,626,2,3,5,0,10,1372
13,309,Wheeler,444,194,924,0,1562,181,191,284,0,656,9,3,23,0,35,2253
13,311,White,3386,2046,6634,6,12072,379,879,1015,0,2273,130,86,155,0,371,14716
13,313,Whitfield,8713,3444,12957,44,25158,2767,2593,4799,18,10177,398,175,388,1,962,36297
13,315,Wilcox,728,338,1303,0,2369,278,181,346,0,805,19,12,25,0,56,3230
13,317,Wilkes,705,458,1644,3,2810,482,709,863,3,2057,26,17,35,0,78,4945
13,319,Wilkinson,1267,239,1099,3,2608,525,575,914,3,2017,32,20,27,0,79,4704
13,321,Worth,2729,753,3242,0,6724,580,781,966,0,2327,56,28,73,0,157,9208